1111111111111111111111111111111111
1E0000000000000C00000C000000000001
101001010010000010100100000K010101
101001001010101000100100000K010101
1P0000000C00C00000000000000K0000C1
1111111111111111111111111111111111